Código (Name)
Português	
pt-BR	Português (Brasil)
pt-PT	Português (Portugal)
Inglês	
en-US	Inglês (Estados Unidos)
en-GB	Inglês (Reino Unido)
en-CA	Inglês (Canadá)
en-AU	Inglês (Austrália)
Espanhol	
es-ES	Espanhol (Espanha)
es-MX	Espanhol (México)
es-AR	Espanhol (Argentina)
Outros	
fr-FR	Francês (França)
de-DE	Alemão (Alemanha)
it-IT	Italiano (Itália)
ja-JP	Japonês (Japão)
zh-CN	Chinês (Simplificado, China)
ru-RU	Russo (Rússia)
ko-KR	Coreano (Coreia)
ar-SA	Árabe (Arábia Saudita)
